29 28
1 1 1 1 1 1 1 1 1 1 1 1 1 0 1 1 1 1 1 1 0 1 1 1 0 1 0 1
0 2 2 2 2 2 2 2 2 2 2 2 4 2 4 2 2 2 2 2 2 2 2 2 2 2 2 0
1 2 1 2 1 1 1 1 1 1 1 2 1 2 1 2 1 2 1 1 1 1 1 1 1 1 2 1
1 2 1 2 2 2 1 2 2 2 1 2 1 2 1 2 1 2 1 2 2 2 1 1 2 2 2 1
1 2 1 2 1 2 1 2 1 2 1 2 1 2 1 2 1 2 1 2 1 2 1 1 2 1 2 1
1 4 1 2 1 2 1 2 1 2 1 2 1 2 1 2 1 2 1 2 1 2 1 3 2 1 2 1
1 7 1 2 1 2 2 2 1 2 2 2 1 2 1 2 1 2 1 2 1 2 1 2 2 1 2 1
1 4 1 2 1 1 1 1 1 2 1 1 1 2 1 2 1 2 1 2 1 2 1 2 2 1 2 1
1 2 3 2 2 2 2 2 2 2 1 2 2 2 1 2 1 2 1 2 1 2 1 2 3 1 2 1
1 2 1 1 1 1 1 1 1 2 1 2 1 1 1 2 1 2 1 2 1 2 1 2 2 1 2 1
1 2 2 2 2 2 2 2 2 2 2 9 2 2 2 2 1 2 1 2 1 2 1 2 2 2 2 1
1 2 1 1 1 1 1 1 1 1 1 2 1 2 1 1 1 2 1 2 1 2 1 2 1 1 2 1
1 2 1 2 2 2 2 2 2 2 1 2 1 2 1 2 2 2 1 2 1 2 1 2 1 2 2 1
1 2 1 2 1 2 1 1 1 2 1 2 1 2 2 2 1 1 1 2 1 2 2 2 1 2 1 1
1 2 1 2 1 2 2 2 1 2 1 2 1 2 1 1 1 2 2 2 1 2 1 1 1 2 1 1
1 2 1 2 2 2 1 2 1 2 3 2 1 2 2 2 1 2 1 1 1 2 2 2 1 2 2 1
1 2 1 1 1 2 1 2 1 2 1 2 1 1 1 2 1 2 1 2 2 2 1 2 2 1 2 1
1 2 2 2 2 2 2 2 1 2 1 2 3 2 2 2 1 2 1 2 1 1 1 1 2 1 2 1
1 2 1 1 1 1 1 2 1 2 1 2 1 1 1 1 1 2 1 2 1 0 0 1 2 1 2 1
1 2 2 2 2 2 2 2 2 2 1 2 2 2 2 2 2 2 1 2 1 1 1 1 2 1 2 1
1 1 1 1 1 2 1 1 1 1 1 2 1 1 1 1 1 2 1 2 2 1 2 2 2 1 2 1
0 2 2 2 2 2 2 2 2 2 1 2 2 2 2 2 2 2 2 1 2 1 2 1 2 1 2 0
1 1 1 1 1 2 1 1 1 2 1 2 1 2 1 2 1 1 2 1 2 1 2 1 2 1 1 1
0 2 2 2 2 2 2 2 2 2 1 2 1 2 1 2 1 1 2 2 2 2 2 2 2 2 2 0
1 1 1 1 1 1 1 1 1 2 1 2 1 2 1 2 1 0 1 4 4 1 1 1 1 2 1 1
1 8 4 2 2 2 2 2 2 2 2 2 4 2 4 2 1 0 1 5 6 1 2 2 2 2 2 1
1 4 1 1 1 1 1 1 1 1 1 2 1 2 1 2 1 1 1 1 1 1 2 1 1 1 2 1
1 2 2 2 2 2 2 2 2 2 2 2 1 2 1 2 2 2 2 2 2 1 2 2 2 1 2 1
1 1 1 1 1 1 1 1 1 1 1 1 1 0 1 1 1 1 1 1 0 1 1 1 0 1 0 1
