6 8
1 1 1 1 1 1 1 1
1 5 6 1 1 7 8 1
1 0 0 0 0 0 1 1
1 1 1 1 1 1 1 1
1 0 0 9 2 2 1 1
1 1 1 1 1 1 1 1
